Destiny Islands = Île du Destin 
Traverse Town = Ville de Traverse 
1st District = Premier Quartier 
2nd District = Deuxième Quartier 
Alleyway = Ruelle VT
Green Room = Chambre verte 
Red Room = Chambre rouge 
Mystical House = Manoir aux hiboux 
Accessory Shop = Joaillerie 
Secret Waterway = Grotte secrète 
Gepetto's House = Maison de Geppetto 
Item Workshop = Atelier 
Dalmatians' House = Maison des dalmatiens 
Magician's Study = Chambre du mage 
Postcard 1 = Carte postale n°1 
Postcard 2 = Carte postale n°2 
Postcard 3 = Carte postale n°3 
Postcard 4 = Carte postale n°4 
Postcard 5 = Carte postale n°5 
Postcard 6 = Carte postale n°6 
Postcard 7 = Carte postale n°7 
Postcard 8 = Carte postale n°8 
Postcard 9 = Carte postale n°9 
Postcard 10 = Carte postale n°10 
Guard Armor = Armure gardienne 
Merlin = Merlin 
Kairi TT4 = Kairi VT4 
End of TT = Fin de VT 
Defeat Leon = Vainquez Léon 
Aerith before Guard Armor = Aerith avant de Armure gardienne 
Fairy Godmother = La Bonne Fée 
Wonderland = Pays des Merveilles 
Rabbit Hole = Terrier de lapin 
Bizarre Room = Pièce mystérieuse 
Lotus Forest = Forêt des lotus
Queen's Castle = Jardin royal 
Tea Party Garden = Jardin privé 
Trickmaster = Maître des Tours 
Olympus Coliseum = Colisée de l'Olympe 
Coliseum Gates = Sortie 
Lobby = Hall CO
Phil Cup = Coupe Philoctète 
Phil Cup Solo = Coupe Philoctète (Combattre seul) 
Phil Cup Time Trial = Coupe Philoctète (Temps limité) 
Pegasus Cup = Coupe Pégase 
Pegasus Cup Solo = Coupe Pégase (Combattre seul) 
Pegasus Cup Time Trial = Coupe Pégase (Temps limité) 
Cloud Hercules Cup = Cloud (Coupe Hercule) 
Hercules Cup = Coupe Hercule 
Hercules Cup Solo = Coupe Hercule (Combattre seul) 
Hercules Cup Time Trial = Couple Hercule (Temps limité) 
Yuffie Hades Cup = Youfie (Coupe Hadès) 
Leon & Cloud Hades Cup = Léon et Cloud (Coupe Hadès) 
Hades Cup = Coupe Hades 
Hades Cup Solo = Coupe Hades (Combattre seul) 
Hades Cup Time Trial = Coupe Hades (Temps limité) 
Ice Titan = Titan de Glace 
Sephiroth = Séphiroth 
Cerberus = Cerbère 
Deep Jungle = Jungle Profonde 
Camp = Campement 
Camp: Tent = Tente 
Climbing Trees = Dôme du grand arbre 
Hippos' Lagoon = Marais 
Jungle: Tunnel = Arbre creux 
Jungle: Vines = Jungle de lianes Sud  
Jungle: Vines 2 = Jungle de lianes Nord 
Waterfall Cavern = Grotte de la cascade 
Cavern of Hearts = Grotte du Cœur 
10 Fruits Jungle Slider = Surf de la Jungle (10 fruits) 
20 Fruits Jungle Slider = Surf de la Jungle (20 fruits) 
30 Fruits Jungle Slider = Surf de la Jungle (30 fruits) 
40 Fruits Jungle Slider = Surf de la Jungle (40 fruits) 
50 Fruits Jungle Slider = Surf de la Jungle (50 fruits) 
Sabor 2 = Sabor n°2 
Jungle: Cliff = Falaise 
Tree House = Cabane 
Agrabah = Agrabah 
Agrabah: Alley = Ruelle AG
Agrabah: Bazaar = Souk 
Agrabah: Main Street = Rue principale 
Agrabah: Plaza = Entrée de la ville 
Agrabah: Storage = Remise 
Aladdin's House = Maison d'Aladdin 
Palace Gates = Portes du palais 
Cave: Entrance = Entrée 
Cave: Hall = Salle principale 
Bottomless Hall = Salle du précipice 
Dark Chamber = Salle des ombres 
Silent Chamber = Salle du silence 
Relic Chamber = Salle des reliques 
Hidden Room = Salle secrète 
Treasure Room = Salle du trésor 
Pot Centipede = Mille-pots 
Kurt Zisa = Kurt Zisa 
Halloween Town = Ville d'Halloween 
Guillotine Square = Place de la guillotine 
Boneyard = Cimetière du chat 
Moonlight Hill = La colline aux citrouilles 
Bridge = Pont 
Oogie Manor = Manoir d'Oogie Boogie 
Cemetary = Jardin des tombeaux 
Oogie Boogie = Oogie Boogie 
Monstro = Monstro 
Monstro: Mouth = Monstro: Bouche 
Chamber 2 = Ventre 2 
Chamber 3 = Ventre 3 
Chamber 5 = Ventre 5 
Chamber 6 = Ventre 6 
Parasite Cage = Parasitocage 
Neverland = Pays Imaginaire 
Ship: Galley = Bateau: Cuisine 
Ship: Hold = Cale 
Ship: Cabin = Cabine 
Captain's Cabin = Cabine du capitaine 
Clock Tower = Grande Horloge 
Pirate Ship = Bateau pirate 
Anti-Sora = Anti-Sora 
Capt. Hook = Capitaine Crochet 
Hollow Bastion = Forteresse Oubliée 
Rising Falls = Chutes ascendantes 
Castle Gates = Portes de la forteresse 
Base Level = Fondations 
Waterway = Sous-sol 
Dungeon = Cellule 
Entrance Hall = Hall FO
Library = Salle de lecture 
Lift Stop = Tour des Passerelles 
Great Crest = Rempart de l'emblème 
High Tower = Sommet 
Grand Hall = Grand hall 
Maleficent = Maléfique 
Dragon Maleficent = Maléfique (Dragon) 
Riku 2 = Riku n°2 
Belle in HB2 = Belle dans FO2 
Behemoth = Behemoth 
Unknown = Inconnu 
End of the World = Fin du Monde 
Final Dimension = Dimension du néant 
Giant Crevasse = Ravin de cristal 
World Terminus = Pandémonium 
Final Rest = Antichambre 
Chernabog = Chernobog 
Hundred Acre Woods = Forêt des Rêves Bleus 
From Owl = du Maître Hibou 
Jungle King = Primitive 
Olympia = Âme de héros 
Three Wishes = Lampe magique 
Pumpkinhead = Tête de citrouille 
Crabclaw = Trésor des mers 
Fairy Harp = Harpe féérique 
Lionheart = Lionheart 
Diamond Dust = Gemme de glace 
One-Winged Angel = Monoptéryx 
Spellbinder = Clairvoyante 
Dream Rod = Sceptre des rêves 
Dream Shield = Bouclier des rêves 
Oathkeeper = Tendre Promesse 
Divine Rose = Rose éternelle 
Metal Chocobo = Chocobo d'Acier 
Ray of Light = Lazurite 
White Fang = Dent de fauve 
Holy Circlet = Talisman 
EXP Necklace = Collier XP 
EXP Ring = Bague d'XP 
Omega Arts = Joyau Oméga 
Raven's Claw = Griffe de corbeau 
Inferno Band = Souffle de l'Enfer 
Brave Warrior = Cor de bravoure 
Ifrit's Horn = Sceau Atomnium 
Zantetsuken = Zantetsuken 
Glide = Vol plané 
Ars Arcanum = Arcanes 
Sonic Blade = Aquilon 
Trinity Limit = Trinité 
Strike Raid = Diskobolos 
Combo Plus = Combo 
Ragnarok = Ragnarok 
Gravity Break = Break Gravité 
Tech Boost = Boost Tech 
Critical Plus = Coups critiques 
High Jump = Super saut 
Superglide = Super vol plané 
Mermaid Kick = Super nage 
Dodge Roll = Roulade 
Dark Matter = Matière noire 
Mythril = Mithril 
Orichalcum = Orichalque 
AP Up = Bonus PC 
Defense Up = Bonus Défense 
Power Up = Bonus Attaque 
Elixir = Elixir 
Magalixir = Mégalixir 
Mega-Elixir = Mégalixir 
Mega-Potion = Mégapotion 
Mega Potion = Mégapotion
Cottage = Pavillon 
Mega-Ether = Mégaéther 
Mythril Shard = Bout de mithril 
Pretty Stone = Jolie pierre 
Gale = Vent 
Naturespark = Orbe de la nature 
Watergleam = Orbe de l'eau 
Earthshine = Orbe de la terre 
Fireglow = Orbe de feu 
Tinker Bell = Clochette 
Genie = Génie 
Cheer (Sora) = Transe (Sora) 
Cheer (Donald) = Transe (Donald) 
Cheer (Goofy) = Transe (Dingo) 
Genji Shield = Bouclier Genji 
Lord Fortune = Bonne fortune 
Save the Queen = Save the Queen 
Save the King = Save the King 
Herc's Shield = Targe d'Hercule 
Postcard = Carte postale 
Khama Vol. 8 = Kahma Volume 8 
Theon Vol. 6 = Taon Volume 6
Log =  Rondin 
Cloth = Grand drap
Rope = Corde 
Seagull Egg = Œuf 
Mushroom = Champignon 
Coconut = Noix de coco 
Fish = Poisson 
Drinking Water = Eau potable 
Emblem Piece (Flame) = Bout d'emblème (Flammes)
Emblem Piece (Fountain) = Bout d'emblème (Fontaine)
Emblem Piece (Chest) = Bout d'emblème (Coffre)
Emblem Piece (Statue) = Bout d'emblème (Statue)
Navi-Gummi = Navigummi 
Torn Page 2 = Page déchirée n°2 
Torn Page 3 = Page déchirée n°3 
Jack-In-The-Box = Boîte à surprise 
Ansem's Report 3 = Rapport d'Ansem 3 
Ansem's Report 7 = Rapport d'Ansem 7 
Ansem's Report 9 = Rapport d'Ansem 9 
Crystal Trident = Cristal royal 
Forget-Me-Not = Myosotis 
Slide 1 = Diapositive n°1 
Slide 2 = Diapositive n°2 
Slide 3 = Diapositive n°3 
Slide 4 = Diapositive n°4 
Slide 5 = Diapositive n°5 
Slide 6 = Diapositive n°6 
Footprints = Trace de pas 
Claw Marks = Marque de griffes  
Strench = Odeur 
Antenna = Epine 
Entry Pass = Billet d'entrée 
Hero License = Licence de héros 
Navi-G Piece 1 = Demi navigummi n°1 
Navi-G Piece 2 = Demi navigummi n°2 
Navi-G Piece 3 = Demi navigummi n°3 
Navi-G Piece 4 = Demi navigummi n°4